wwwwwwwwwwwwwwwwwwwwwww
wp.......wgw........wgw
www......w.w.....bbbw.w
wgw......w.w........w.w
w.w......w.w........w.w
w.w......w.w........w.w
w.....................w
w.....................w
wwwwwwwwwwwwwwwwwwwwwww