wwwwwww
wg..g.w
w.pbg.w
w.bgb.w
w.bB..w
w.....w
wwwwwww