wwwwwww
wp....w
w...b.w
w...b.w
ww..w.w
wg..g.w
wwwwwww